########
#M     #
#B    L#
#XXXX  #
#L     #
#   XX #
#     $#
########
