########
#M     #
#B  L  #
#XXXX  #
#B LX $#
#XXXXX #
#      #
########
