########
#M    L#
#B     #
#XXXX  #
#B LX  #
#X  XX #
#     $#
########
