########
#M L   #
#     L#
# XXX  #
#L     #
#   XX #
#     $#
########
